########
#__#.__#
#_$#___#
#__#_@##
#__#_$##
#____.##
########