#########
#__#___.#
#@$_$___#
#_$_##..#
#___#####
#########