########
#______#
#__$__.#
#@_$__.#
#__$__.#
#______#
########