########
#____###
#@$__###
####_###
##___###
##____##
#__##._#
#______#
#####__#
########