#########
##__#___#
#.$.__$_#
#_#__##_#
#_@$.$._#
#########